TTTTTTTTTTTTTTTTTTTTTTTTTTTTTTTTTTTTTTTTTTTTTTTTTTTTTTTTTTTTTT
TTTTTTTTTTTTTTTTTTTTTTTTTTTTTTTTTTTTTTTTTTTTTTTTTTTTTTTTTTTTTT
TT               TTT00                       TT             TT
TT            TTTT                     0TTT   TTT           TT
TT          0TTTTTTT                   TTT   TTT            TT
TTT           TTTT00TT                 TTT   TTT0           TT
TTTTT             TT    TTT000        T00TT   TTTTTTTT0     TT
TTTTTT00              TTTTTTTTTT0    TTTTTT      TTTTTT     TT
TTTTT            TTTTTTTTTT00TTTTT0TTTTTTTTTT      TTT      TT
TTTTTTTTTTTT       TTTTTTTTTTTTTTTTTTTT           TTTTT     TT
TTTTTTTTTTTTT     TTTTTTTTT         TTTTTTTTTT   TTTT       TT
TTTTTTTTTT          TTTTTT             TTTT        TTT      TT
TTTTTTT               TTT               TT         T        TT
TTTTTT0                T      00TT    TTTT                  TT
TTTT0000              TT       00TT     TT        TT0       TT
TT0000T           TT00T0T     TT0T0      TT        0TT      TT
TTTTTTTT0000T    TTTTTTTTT     TTTTT     TTT       TTT      TT
TTT00T         TTTTT00TT         TT0T     TTT       TTTT0T00TT
TTTTTTT   U        TTTT          TTT     TT        TT00     TT
TTT0T0T       TTTT00T0TTTT       TTTTT     TTT           TTTTT
TTTTTTTTTTTTTTTTTTT000TTTT      TTTT                 TTTTTTTTT
TT                             T0000T                       TT
TT                            TTTTT                         TT
TTTTTTTTTTTTTTTTTTTTTTTTTTTTTTTTTTTTTTTTTTTTTTTTTTTTTTTTTTTTTT
TTTTTTTTTTTTTTTTTTTTTTTTTTTTTTTTTTTTTTTTTTTTTTTTTTTTTTTTTTTTTT